F  100,100,100
    NO ./assets/luffy.png
    SO ./assets/luffy.png




WE ./assets/luffy1.png
EA ./assets/luffy1.png
C        0,0,100


1111111111111111111111111111111111111111111
1000000000000000000000000000000000000000001
1000000000000000000000000000000000000000001
1000000000000000000000000000000000000000001
1000000000000000000000000000000000000000001
1000000000000000000000000000000000000000001
1000000000000000000000000000000000000000001
1000000000000000110000000W00000000000000001
1000000000000000110000000000000000000000001
1000000000000000000000000000000000000000001
1000000000000000000000000000000000000000001
1000000000000000000000000000000000000000001
1000000000000000000000000000000000000000001
1000000000000000000000000000000000000000001
1000000000000000000000000000000000000000001
1100000111010101111000000000000000000000001
11110011 1010101 10000000000000000000000001
11111111 1111111 11111111111111111111111111