F  65,56,49
    NO ./assets/1.png
    SO ./assets/1.png




WE ./assets/2.png
EA ./assets/2.png
C  100,91,92









                       1111111111111111
                      10000000000000001
                      10111111111111001
1111111111111111111111101          1001
1000000000000000000000001          1001
1000000000000000000000001          1001
100001000000000000000000111111     1001
100000001000000000000000000001     1001
100000000111100000000000111101     1001
1000000001001000000000001 1101     1001
1000000001111000000000001 1101     1001
1000000000000000000000001   1      1001
1000000000000000000000001   111    1001
1000000100000000W00000001   101    1001
1000000000000000000000001   111    1001
100000000000001000000000111111111111011
10000011000000000000000000000000000001
11111111111111111111111111111011111111
                            101
                            101
                             1