F  100,100,100
    NO ./assets/60pixels.png
    SO ./assets/60pixels.png




WE ./assets/60pixels.png
EA ./assets/60pixels.png
C        0,0,100



1111111111111111111111
1000000000000000000101
1000010000000000000001
1000000000000000000001
1000001000000000000001
10000000000000000N0001
1000000000000000000001
1000000000000000000001
1000000000000000000001
1000000000000000000001
1000000000000000000001
1000000000000000000001
1111111111111111111111