F  100,100,100
    NO ./assets/60pixels.png
    SO ./assets/60pixels.png




WE ./assets/97.png
EA ./assets/97.png
C        0,0,100



        1111111111111111111111111111111111111111111111111111111111111111111111
        10000000001100000000000000000000000000000000000000000000000000011111111111111111111111111111111111111111111111111111
        101100000111000000000000000000000000000000000000000000000000000000000000000000000000000000000000000000000000000000001
        10010000000000000000000000000000000000000000000000000000000000011111111111111111111111111111111111111111011111111111
111111111011000001110000000000000000000000000000000000000000000000000001                                       101
100000000011000001110000000000000000000000000000000000000000111111111111                                       101
111101111111110111000000000000000000000000000000000000000000000000011111111111111111111111111111111111111111111101111111111111111111111111
1111011111111101110100000000000000000000000000000000000000001001000000000000000000000000000000000000000000000000000000000000000000000000001
110000001101010111000000000000000000000000000000000000000000000100011111111111111111111111111111111111111111111111111111111111111111111111
10000100000000001100000000000000000000000000000000000000000000010001
10000000000000001101000000000000000000000000000000000000000010010001
11000001110101011111000000000000000000000000000000000000000011110N0111
11110111 1110101 101000000000000000000000000000000000000000011010001
11111111 1111111 111111111111111111111111111111111111111111111111111