F  220,100,0
    NO ./path_to_the_north_texture 
    SO ./path_to_the_south_texture  




WE ./path_to_the_west_texture
EA ./path_to_the_east_texture
C        200,30,6



11111111111111111111111111
10000000000011000000000001
10110000000111000000000001
10010000000000000000000001
11111111101100000000000001
10000000001100000011111111
11110111111111000000010001
11110111111111000000010001
11000000110101000000010001
10S00000000000000000010001
10000000000000000000010001
11000000000101000000000111
11110110001101011111110111
11111111111111111111111111
    