F  220,100,0
    NO ./path_to_the_north_texture 
    SO ./path_to_the_south_texture  




WE ./path_to_the_west_texture
EA ./path_to_the_east_texture
C        200,30,6



1111111111111
1000000000001
100010N000001
1000000000001
1000000000001
1111111111111
