F  220,100,0
    NO ./path_to_the_north_texture 
    SO ./path_to_the_south_texture  




WE ./path_to_the_west_texture
EA ./path_to_the_east_texture
C        200,30,6



11111111111111111   11111111111
10000000000011001   10000000001
10110000000111001   10000000001
10010000000000001   10000000001
11111111101100001   10000000001
10000000001100001   10011111111
11110111111111001   10000010001
11110111111111001   10000010001
1100000011010100111110000010001
10S0000000000000000000000010001
1000000000000000111110000010001
11000000000101001   10000000111
11110110001101011   11111110111
11111111111111111   11111111111