F  220,100,0
    NO ./path_to_the_north_texture 
    SO ./path_to_the_south_texture  




WE ./path_to_the_west_texture
EA ./path_to_the_east_texture
C        200,30,6



        1111111111   1111111111111111
        1000000001   1011000000000001
        1011000001   1111000000000001
        1001000001   1000000000000001
111111111011000001   1111000000000001
100000000011000001   1111011111111111
111101111111110111   1100000000010001
111101111111110111   1101010000010001
110000001101010111   1100000000010001
10S000000000000011   1100000000010001
100000000000000011   1101010000010001
110000011101010111   1111111100000111
11110111 1110101     1011101000111
11111111 1111111     11111111111
    