F  220,100,0
    NO ./path_to_the_north_texture 
    SO ./path_to_the_south_texture  




WE ./path_to_the_west_texture
EA ./path_to_the_east_texture
C        200,30,6



11111111111111111
10000000000000001
100S0000001101101
10000001010000001
10000000000100001
10100000000000001
11111111111111111