F  100,100,100
    NO ./assets/60pixels.png
    SO ./path_to_the_south_texture  




WE ./path_to_the_west_texture
EA ./path_to_the_east_texture
C        0,0,100



1111111111111111111111111111111111111111111111111
1000000000100010001000100010001000100010001000101
1000100000000000000000000000000000000000000000001
1000000000000000000000000000000000000000000000001
1000000100000000000000000000000000000000000000001
1000000000000000000000000000000000000000000000001
1000000100000000000000000000000000000000000000001
1000000000000000000000000000000000000000000000001
1000000100000000000000000000000000000000000000001
1000000000000000000000000000000000000000000000001
1000000100000000000000000000000000000000000000001
1000000000000000000000000000000000000000000000001
1000000100000000000000000000000000000000000000001
10000000000000000000000N0000000000000000000000001
1000000100000000000000000000000000000000000000001
1000000000000000000000000000000000000000000000001
1000000100000000000000000000000000000000000000001
1000000000000000000000000000000000000000000000001
1000000100000000000000000000000000000000000000001
1000000000000000000000000000000000000000000000001
1000000100000000000000000000000000000000000000001
1000000000000000000000000000000000000000000000001
1000000100000000000000000000000000000000000000001
1000000000000000000000000000000000000000000000001
1000000100000000000000000000000000000000000000001
1000000000000000000000000000000000000000000000001
1000000100000000000000000000000000000000000000001
1111111111111111111111111111111111111111111111111