F  65,56,49
    NO ./assets/1.png
    SO ./assets/2.png


WE ./assets/3.png 
EA ./assets/4.png







C  100,91,90


                1111111111111111
               10000000000000001
               10111111111111001    11
1111111111111111111111101    11    1001
1000000000000000000000001          1001
1000000000000000000000001          1001
100001000000000000000000111111     1001
100000001000000000000000000001     1001
100000000111100000000000111101     1001
1000000001001000000000001 1101     1001
1000000001111000000000001 1101     1001
1000000000000000000000001   1      1001
1000000000000000000000001   111    1001
1000000101000000W00000001   101    1001
1000000000000000000000001   111    1001
100000000000001000000000111111111111011
10000011000010000000000000000000000001
111111111111 1111111111111111011111111
111111111111 11111111111111111111111