F  220,100,0
    NO ./path_to_the_north_texture 
    SO ./path_to_the_south_texture  




WE ./path_to_the_west_texture
EA ./path_to_the_east_texture
C        200,30,6



1111111111
1000000101
10100S0001
1001000101
1111111111