F  100,100,100
    NO ./assets/frame1.png
    SO ./path_to_the_south_texture  




WE ./path_to_the_west_texture
EA ./path_to_the_east_texture
C        0,0,100



1111111111111111111111
1100001000100010000101
1000100000100000010001
1000100000100000010001
1000100000100000010001
100000010000N001000101
1111111111111111111111