F  100,100,100
    NO ./assets/tst.png
    SO ./path_to_the_south_texture  




WE ./path_to_the_west_texture
EA ./path_to_the_east_texture
C        0,0,100



1111111111111111111111
1000001000100000000101
1000000000000000000001
1000000000000000000001
1000000000100000000001
1000000000000000000001
1000000000000000000001
1000000000000000000001
1000000000000000000001
10000000000000000N0001
1000000000000000000001
1000000000000000000001
1000000000000000000001
1000000000000000000001
1000000000000000000001
1000000000000000000001
1111111111111111111111