F  220,100,0
    NO ./path_to_the_north_texture 
    SO ./path_to_the_south_texture




WE ./path_to_the_west_texture
EA ./path_to_the_east_texture

C        200,30,6


        1111111111111111    1111111111
        1000000000110001    1000000001
        1011000001110001    1000000001
        1001000000000001    1000000001
111111111011000001110001    1000000001
100000000011000001110111    1111111111
111101111111110111000001    110001
111101111111110111010101    110001
110000001101010111000001    110001
10S000000000000011000001    110001
100000000000000011010101    110001
110000011101010111111111    110000111
11110111 1110101     101    1111010001
11111111 1111111     111    1111111111
    