
        1111111111111111111111111111111111111111111111111111111111111111111111
        10000000001000000000000000000000000000000000000000000000000000011111111111111111111111111111111111111111111111111111
        101100000110000000000000000000000000000000000000000000000000000000000000000000000000000000000000000000000000000000001
        10010000000000000000000000000000000000000000000000000000000000011111111111111111111111111111111111111111011111111111
111111111011000001100000000000000000000000000000000000000000001111111001                                       101
100000000011000001100000000000000000000000000000000000000000111000001111                                       101
11110111111111011100000000000000000000000000000000000000000000000N001111111111111111111111111111111111111111111101111111111111111111111111
1111011111111101110000000000000000000000000000000000000000001010000010000000000000000000000000000000000000000000000000000000000000000000001
110000001101010111000000000000000000000000000000000000000000011111111111111111111111111111111111111111111111111111111111111111111111111111
10000000000000000000000000000000000000000000000000000000000000010001
10000000000000000000000000000000000000000000000000000000000010010001
10000000000000000000000000000000000000111111111000000000000000010001
100000000000000000000000000000000000001       1000000000000010010001
100000000000000000000000000000000000001       1000000000000000010001
100000000000000000000000000000000000001       1000000000000010010001
100000000000000000000000000000000000001       1000000000000000010001
100000000000000000000000000000000000001       1000000000000010010001
10000000000000000000000000000000000000111111111000000000000000010001
10000000000000000000000000000000000000000000000000000000000010010001
10000000000000000000000000000000000000000000000000000000000000010001
10000000000000000000000000000000000000000000000000000000000010010001
10000000000000000000000000000000000000000000000000000000000000010001
10000000000000000000000000000000000000000000000000000000000010010001
10000000000000000000000000000000000000000000000000000000000000010001
10000000000000000000000000000000000000000000000000000000000010010001
10000000000000000000000000000000000000000000000000000000000000010001
10000000000000000000000000000000000000000000000000000000000010010001
10000000000000000000000000000000000000000000000000000000000000010001
10000000000000000000000000000000000000000001111110000000000010010001
1000000000000000000000000000000000000000001      1000000000000010001
1000000000000000000000000000000000000000001      1000000000010010001
1000000000000000000000000000000000000000001      1000000000000010001
1000000000000000000000000000000000000000001      1000000000010010001
1000000000000000000000000000000000000000001      1000000000000010001
1000000000000000000000000000000000000000001      1000000000010010001
1000000000000000000000000000000000000000001      1000000000000010001
1000000000000000000000000000000000000000001      1000000000010010001
1000000000000000000000000000000000000000001      1000000000000010001
1000000000000000000000000000000000000000001      1000000000010010001
1000000000000000000000000000000000000000001      1000000000000010001
1000000000000000000000000000000000000000001      1000000000010010001
1000000000000000000000000000000000000000001      1000000000000010001
1000000000000000000000000000000000000000001      1000000000010010001
1100000111010101111000000000000000000000001      100000000001111000111
11110011 1110101 10000000000000000000000001      1000000000011010001
11111111 1111111 11111111111111111111111111      1111111111111111111